...........................
...........................
......xxx..................
......x.x...........xxx....
xxxxxxxxx...........x.x....
......x.............x.x....
......x.............x.x....
....xxxxxxxxxxxxxxxxx.x....
....x.x...............x....
....xxx.....xxxxxxxxxxx....
............x..............
............S..............
