...........................
..xxxxxxxxxxx.xxxxxxxxxxx..
..x.........x.x.........x..
..x.........x.x.........x..
..xxxxxxxx..x.x..xxxxxxxx..
.........x..x.x..x.........
.........x..x.x..x.........
.........x..x.x..x.........
..xxxxxxxx..x.x..xxxxxxxx..
..x.........x.x.........x..
..x...xxxx..xxx..xxxx...x..
..xxxxx..x.......x..xxxxx..
.........S.......x.........
