...........................
...........................
..........xxx.xxx..........
..........x.x.x.x..........
......xxx.x.x.x.x.xxx......
..xxx.x.x.x.x.x.x.x.x.xxx..
Sxx.x.x.x.x.x.x.x.x.x.x.xxx
....xxx.x.x.x.x.x.x.xxx....
........x.x.x.x.x.x........
........xxx.x.x.xxx........
............xxx............
...........................
...........................
